{
    "grid-000-n": [
        "......00..G",
        ".55...0..4.",
        ".5....0.444",
        ".5...#.....",
        ".....#.....",
        "...#####...",
        "..S..#...33",
        "111..#....3",
        "1...2.....3",
        "..222......",
        "..........."
    ],
    "grid-001-n": [
	"........4G.",
        "..0.....4..",
        "..00....44.",
        "..0..#.....",
        ".....#.....",
        "555#####2..",
        "..5..#.222.",
        ".....#.....",
        "..33.......",
        "...3.....1.",
        "..S3....111"
    ],
    "grid-002-n": [
        "G......3...",
        "4......3...",
        "444....33..",
        ".....#.....",
        "..0..#.....",
        "000#####...",
        ".....#.5..2",
        ".1...#.5..2",
        "111...55.22",
        "...........",
        "S.........."
    ],
    "grid-003-n": [
        "...333.....",
        "....3......",
        ".0.....444.",
        ".0...#..G4.",
        ".00..#.....",
        "...#####222",
        ".....#....2",
        ".....#.5...",
        ".S1...55...",
        ".11....5...",
        "..1........"
    ],
    "grid-004-n": [
        "...333.....",
        "....3....4.",
        "........44.",
        ".....#..G4.",
        "000..#....2",
        ".0.#####.22",
        ".....#....2",
        "..1..#.5...",
        "..1....5...",
        "S.1....5...",
        "..1....5..."
    ],
    "grid-005-n": [
	"..0...44...",
        ".00....4...",
        "..0....4..1",
        ".S...#...11",
        "5....#....1",
        "555#####...",
        ".....#.22..",
        ".333.#.2...",
        "...3...2...",
        ".G.........",
        "..........."
    ],
    "grid-006-n": [
        ".......3.G.",
        "...4...3...",
        "..44...33..",
        "0.4..#.....",
        "00...#...2.",
        "0..#####222",
        ".....#.....",
        ".1...#.....",
        ".11.....S..",
        ".1....5....",
        "......555.."
    ],
    "grid-007-n": [
        "..33..00...",
        ".33...00...",
        "S..........",
        ".....#..44.",
        ".5...#...4.",
        "555#####.4.",
        ".....#.....",
        ".....#.....",
        "1111..222..",
        "....G...2..",
        "..........."
    ],
    "grid-008-n": [
        "..44.......",
        ".S4........",
        "..4........",
        ".....#.3333",
        "..0..#.....",
        "000#####55.",
        ".....#...5.",
        ".G...#...5.",
        "..1........",
        "111...222..",
        ".......2..."
    ],
    "grid-009-t": [
        "....S......",
        "..4.....3..",
        "444....33..",
        ".....#.3...",
        "..0..#.....",
        "000#####...",
        ".....#.....",
        "...G.#55..2",
        "111...55..2",
        ".1.......22",
        "..........."
    ],
    "grid-010-n": [
	".......44..",
        ".00...44.S.",
        ".00........",
        ".....#.....",
        "5....#....1",
        "55.#####111",
        "5....#.....",
        ".33..#.....",
        "..33....222",
        "........2G.",
        "..........."
    ],
    "grid-011-n": [
	"........4.S",
        ".00.....44.",
        "..00....4..",
        ".....#.....",
        "5....#..1..",
        "555#####11.",
        ".....#..1..",
        ".....#.....",
        ".33.....22.",
        ".G3....22..",
        "..3........"
    ]
}