{
    "grid-000-l": [
        "...3..00..G",
        ".333..0..4.",
        "......0.444",
        "5....#.....",
        "5....#.....",
        "5..#####...",
        "5....#.....",
        ".11..#.2...",
        "11....222..",
        "...........",
        "S.........."
    ],
    "grid-001-l": [
        "G.44...3333",
        "..4........",
        "..4.....555",
        ".....#...5.",
        "..0..#.....",
        "000#####...",
        ".....#.....",
        ".....#....2",
        "..1.......2",
        "111......22",
        "S.........."
    ],
    "grid-002-l": [
        "G..........",
        "4......3333",
        "444........",
        ".....#.....",
        "..0..#.....",
        ".00#####...",
        "..0..#..5..",
        ".....#.555.",
        "111........",
        "..1.....222",
        "S........2."
    ],
    "grid-003-l": [
        "5..........",
        "5........4.",
        "55.G.....4.",
        ".....#..44.",
        ".2...#.....",
        ".22#####333",
        ".2...#....3",
        ".....#.00..",
        "11.....0...",
        ".11....0...",
        "...S......."
    ],
    "grid-004-l": [
        "...........",
        ".11..G.....",
        "..11...4...",
        ".....#.444.",
        "222..#....3",
        "..2#####.33",
        ".....#.0..3",
        ".....#000..",
        "...........",
        ".5555......",
        "..........S"
    ],
    "grid-005-l": [
        "..44...3...",
        "...4G..3...",
        "...4...33..",
        "00...#.....",
        "0....#...2.",
        "0..#####222",
        ".....#.....",
        ".1...#.....",
        ".11...555..",
        ".1......5..",
        "S.........."
    ],
    "grid-006-l": [
        "......00...",
        "S.....0..4.",
        ".55...0.444",
        "..5..#.....",
        "..5..#.....",
        "...#####...",
        ".333.#.....",
        "..3..#.2...",
        "1.....222..",
        "111........",
        "G.........."
    ],
    "grid-007-l": [
        ".S.........",
        "4..........",
        "444...333..",
        ".....#.3...",
        "..0..#.....",
        ".00#####...",
        "..0..#.....",
        ".....#5...2",
        "111.G.55..2",
        "..1...5..22",
        "..........."
    ],
    "grid-008-l": [
        "G..00......",
        ".3..0...444",
        "333.0....4.",
        ".....#.....",
        ".....#...55",
        "...#####.55",
        ".....#.....",
        "...2.#..11.",
        "..222....11",
        "...........",
        ".........S."
    ],
    "grid-009-l": [
	".........4.",
        "G0.......4.",
        "00......44.",
        ".0...#.....",
        ".....#....2",
        "..5#####222",
        "1.555#.....",
        "1....#..333",
        "1.........3",
        "1....S.....",
        "..........."
    ],
    "grid-010-l": [
        "..4444.33.G",
        "5.......3..",
        "555.....3..",
        ".....#.....",
        ".....#....0",
        "...#####000",
        ".....#.....",
        "1....#.....",
        "11......2.S",
        "1.......222",
        "..........."
    ],
    "grid-011-l": [
        "..........G",
        "..........3",
        ".444....333",
        "..4..#.....",
        ".....#..0..",
        "...#####00.",
        ".2...#..0..",
        ".2..5#.....",
        ".2.55...111",
        ".2..5.....1",
        "........S.."
    ]
}