{
    "grid-000-n": [
        "......00..G",
        "......0..4.",
        "......0.444",
        ".....#.....",
        "55...#.....",
        ".55#####...",
        "..S..#...33",
        "111..#....3",
        "1...2.....3",
        "..222......",
        "..........."
    ],
    "grid-001-n": [
	"..000...4..",
        "..0..G..4..",
        "........4..",
        ".....#..4..",
        ".....#.....",
        "555#####2..",
        "5....#222.1",
        ".....#....1",
        "..........1",
        ".3333.....1",
        "S.........."
    ],
    "grid-002-n": [
        "G.44.....5.",
        "..4......5.",
        "..4......55",
        ".....#.....",
        "..0..#222..",
        "000#####2..",
        ".....#...3.",
        ".....#.333.",
        ".11........",
        ".11........",
        ".....S....."
    ],
    "grid-003-n": [
        "G......3...",
        "4......3...",
        "444....33..",
        ".....#.....",
        "..0..#.....",
        "000#####...",
        ".....#.5..2",
        ".1...#.5..2",
        "111...55.22",
        "...........",
        "S.........."
    ],
    "grid-004-n": [
        "....3....44",
        "....3G...4.",
        ".0..3....4.",
        ".0..3#.....",
        ".00..#.....",
        "...#####...",
        ".....#.5..2",
        ".1...#.5..2",
        "111...55.22",
        "...........",
        "S.........."
    ],
    "grid-005-n": [
        ".G.333...44",
        "....3....4.",
        ".0.......4.",
        ".0...#.....",
        ".00..#.....",
        "...#####222",
        ".....#....2",
        ".....#5....",
        "111...5..S.",
        ".1....55...",
        "..........."
    ],
    "grid-006-n": [
        "...333.....",
        "....3......",
        ".0.....444.",
        ".0...#..G4.",
        ".00..#.....",
        "...#####222",
        ".....#....2",
        ".....#.5...",
        ".S1...55...",
        ".11....5...",
        "..1........"
    ],
    "grid-007-n": [
        "...333.....",
        "....3....4.",
        "........44.",
        ".....#..G4.",
        "000..#....2",
        ".0.#####.22",
        ".....#....2",
        "..1..#.5...",
        "..1....5...",
        "S.1....5...",
        "..1....5..."
    ],
    "grid-008-n": [
	"..0...44...",
        ".00....4...",
        "..0....4..1",
        ".S...#...11",
        "5....#....1",
        "555#####...",
        ".....#.22..",
        ".333.#.2...",
        "...3...2...",
        ".G.........",
        "..........."
    ],
    "grid-009-n": [
        "G........5.",
        "4444.....5.",
        ".........55",
        ".....#.....",
        "0....#....2",
        "000#####.22",
        ".....#33..2",
        ".....#.33..",
        ".1111......",
        "...........",
        "..S........"
    ],
    "grid-010-n": [
        "......33...",
        ".......3G..",
        ".......3...",
        ".00..#.....",
        "00...#...2.",
        "...#####222",
        ".1...#.....",
        "11...#.555.",
        ".1......5..",
        ".....44....",
        "..S...44..."
    ],
    "grid-011-n": [
        ".44........",
        ".4..55.....",
        ".4..5..G...",
        "....5#.....",
        "..00.#...2.",
        ".00#####222",
        ".....#.....",
        "..1..#.....",
        ".11.....3.S",
        "..1....333.",
        "..........."
    ],
    "grid-012-n": [
        "..44...3.G.",
        "...4...3...",
        "...4...33..",
        "0....#.....",
        "0....#...2.",
        "00.#####222",
        ".....#.....",
        ".1...#.....",
        ".11.....S..",
        ".1...55....",
        "......55..."
    ],
    "grid-013-n": [
        "..33..00...",
        ".33.S.0....",
        "......0..44",
        ".5...#...4.",
        "55...#...4.",
        ".5.#####...",
        ".....#..G..",
        ".....#.2...",
        "1111..222..",
        "...........",
        "..........."
    ],
    "grid-014-n": [
	"..0...44...",
        "S.0....4...",
        ".00....4...",
        ".....#....1",
        "5....#...11",
        "555#####..1",
        ".....#.....",
        ".3...#..222",
        ".33.....2..",
        ".3.......G.",
        "..........."
    ],
    "grid-015-n": [
        "..44.......",
        ".S4........",
        "..4........",
        ".....#.3333",
        "..0..#.....",
        "000#####55.",
        ".....#...5.",
        ".G...#...5.",
        "..1........",
        "111...222..",
        ".......2..."
    ],
    "grid-035-t": [
        ".S.........",
        "4..........",
        "444...333..",
        ".....#.3...",
        "..0..#.....",
        ".00#####...",
        "..0..#.....",
        ".....#5...2",
        "111.G.55..2",
        "..1...5..22",
        "..........."
    ]
}