{
    "grid-000-l": [
        "...3..00..G",
        ".333..0..4.",
        "......0.444",
        "5....#.....",
        "5....#.....",
        "5..#####...",
        "5....#.....",
        ".11..#.2...",
        "11....222..",
        "...........",
        "S.........."
    ],
    "grid-001-l": [
	"..0......4G",
        ".00......4.",
        "..0......4.",
        ".....#...4.",
        "5....#.....",
        "555#####2..",
        ".....#222.1",
        ".333.#....1",
        "...3......1",
        "..........1",
        "S.........."
    ],
    "grid-002-l": [
        "G.44...3333",
        "..4........",
        "..4.....555",
        ".....#...5.",
        "..0..#.....",
        "000#####...",
        ".....#.....",
        ".....#....2",
        "..1.......2",
        "111......22",
        "S.........."
    ],
    "grid-003-l": [
        "G..........",
        "4......3333",
        "444........",
        ".....#.....",
        "..0..#.....",
        ".00#####...",
        "..0..#..5..",
        ".....#.555.",
        "111........",
        "..1.....222",
        "S........2."
    ],
    "grid-004-l": [
        "..11.......",
        "...1.G...4.",
        "...1.....4.",
        ".2...#..44.",
        ".2...#.....",
        ".22#####333",
        ".....#....3",
        "555..#.....",
        "5.......0..",
        ".S.....000.",
        "..........."
    ],
    "grid-005-l": [
        "5..........",
        "5........4.",
        "55.G.....4.",
        ".....#..44.",
        ".2...#.....",
        ".22#####333",
        ".2...#....3",
        ".....#.00..",
        "11.....0...",
        ".11....0...",
        "...S......."
    ],
    "grid-006-l": [
        "...........",
        ".11..G.....",
        "..11...4...",
        ".....#.444.",
        "222..#....3",
        "..2#####.33",
        ".....#.0..3",
        ".....#000..",
        "...........",
        ".5555......",
        "..........S"
    ],
    "grid-007-l": [
        "1111.......",
        ".....G.....",
        ".........4.",
        ".....#.444.",
        "22...#....3",
        ".22#####.33",
        ".....#.0..3",
        ".555.#.00..",
        ".5.....0...",
        "...........",
        "....S......"
    ],
    "grid-008-l": [
        "..44.....5.",
        "...4.G...5.",
        "...4.....55",
        ".....#.....",
        "0....#..2..",
        "00.#####222",
        "0....#.....",
        ".....#..33.",
        ".1111...3..",
        "....S...3..",
        "..........."
    ],
    "grid-009-l": [
        "G......3...",
        "4......3...",
        "444....33..",
        ".....#.....",
        "..0..#...22",
        "000#####..2",
        ".....#..5.2",
        ".11..#..5..",
        ".11....55..",
        ".....S.....",
        "..........."
    ],
    "grid-010-l": [
        "..44.......",
        "..4...5555.",
        "..4....G.5.",
        ".....#..2..",
        "..0..#222..",
        "000#####...",
        ".....#.333.",
        ".....#...3.",
        ".11........",
        ".11.S......",
        "..........."
    ],
    "grid-011-l": [
        "..44...3...",
        "...4G..3...",
        "...4...33..",
        "00...#.....",
        "0....#...2.",
        "0..#####222",
        ".....#.....",
        ".1...#.....",
        ".11...555..",
        ".1......5..",
        "S.........."
    ],
    "grid-012-l": [
        "......00...",
        "S.....0..4.",
        ".55...0.444",
        "..5..#.....",
        "..5..#.....",
        "...#####...",
        ".333.#.....",
        "..3..#.2...",
        "1.....222..",
        "111........",
        "G.........."
    ],
    "grid-013-l": [
	"..0....4...",
        "S.0...44...",
        ".00....4...",
        ".....#.....",
        "5....#...11",
        "555#####..1",
        ".....#..2.1",
        ".3...#.22..",
        "G33....2...",
        ".3.........",
        "..........."
    ],
    "grid-014-l": [
        "...........",
        "..44.....3.",
        ".44......3S",
        ".....#...33",
        ".0...#.....",
        "000#####55.",
        ".....#...5.",
        ".....#...5.",
        "..1....2...",
        "111.G.22...",
        ".......2..."
    ],
    "grid-015-l": [
        ".S.........",
        "4..........",
        "444...333..",
        ".....#.3...",
        "..0..#.....",
        ".00#####...",
        "..0..#.....",
        ".....#5...2",
        "111.G.55..2",
        "..1...5..22",
        "..........."
    ],
    "grid-016-l": [
        "G..00......",
        ".3..0...444",
        "333.0....4.",
        ".....#.....",
        ".....#...55",
        "...#####.55",
        ".....#.....",
        "...2.#..11.",
        "..222....11",
        "...........",
        ".........S."
    ],
    "grid-017-l": [
	".........4.",
        "G0.......4.",
        "00......44.",
        ".0...#.....",
        ".....#....2",
        "..5#####222",
        "1.555#.....",
        "1....#..333",
        "1.........3",
        "1....S.....",
        "..........."
    ],
    "grid-018-l": [
        "..4444.33.G",
        "5.......3..",
        "555.....3..",
        ".....#.....",
        ".....#....0",
        "...#####000",
        ".....#.....",
        "1....#.....",
        "11......2.S",
        "1.......222",
        "..........."
    ],
    "grid-019-l": [
        "..........G",
        "..........3",
        ".444....333",
        "..4..#.....",
        ".....#..0..",
        "...#####00.",
        ".2...#..0..",
        ".2..5#.....",
        ".2.55...111",
        ".2..5.....1",
        "........S.."
    ],
    "grid-020-l": [
        "..11.......",
        "..11.G.444.",
        ".........4.",
        ".....#..3..",
        ".2...#..3..",
        "222#####33.",
        ".....#.....",
        ".....#..555",
        ".0........5",
        "000.....S..",
        "..........."
    ],
    "grid-021-l": [
        "5..........",
        "5.....444..",
        "55.G..4....",
        ".....#.....",
        ".2...#....3",
        "222#####.33",
        ".....#.0..3",
        ".....#.0...",
        "11.....00..",
        ".11.S......",
        "..........."
    ],
    "grid-022-l": [
        ".1.G.......",
        ".111.......",
        ".........4.",
        "2....#.444.",
        "22...#....3",
        "2..#####333",
        "..5..#.....",
        ".55..#..0..",
        "..5....00..",
        ".....S..0..",
        "..........."
    ],
    "grid-023-l": [
        "..........G",
        "1111...4444",
        "...........",
        ".....#.....",
        "..2..#..3..",
        "222#####33.",
        ".....#..3..",
        ".555.#.....",
        ".5.........",
        ".......0000",
        "..........S"
    ]
}