{
    "grid-000-n": [
        "......0...4",
        ".55...0...4",
        ".5....0.G.4",
        ".5...#0...4",
        ".....#.....",
        "111#####...",
        "..1..#.....",
        ".....#...3.",
        "...22...33.",
        "..22....3..",
        "S.........."
    ],
    "grid-001-n": [
	"........4G.",
        "..0.....4..",
        "..00....44.",
        "..0..#.....",
        ".....#....2",
        "555#####..2",
        "5....#....2",
        ".S...#....2",
        "..33.......",
        ".33......1.",
        "........111"
    ],
    "grid-002-n": [
        "G......3...",
        "4......3...",
        "444....33..",
        ".....#.....",
        "..0..#.....",
        "000#####...",
        ".....#.5..2",
        ".1...#.5..2",
        "111...55.22",
        "...........",
        "S.........."
    ],
    "grid-003-n": [
        "..333......",
        "....3.....4",
        ".0......444",
        ".0...#..G..",
        ".00..#.....",
        "...#####222",
        ".....#....2",
        ".....#.5...",
        ".S1...55...",
        ".11....5...",
        "..1........"
    ],
    "grid-004-n": [
        "...333.....",
        "....3....4.",
        "........44.",
        ".....#..G4.",
        "000..#....2",
        ".0.#####.22",
        ".....#....2",
        "..1..#.5...",
        "..1....5...",
        "S.1....5...",
        "..1....5..."
    ],
    "grid-005-n": [
	"..0...44...",
        ".00....4...",
        "..0....4..1",
        ".S...#...11",
        "5....#....1",
        "555#####...",
        ".....#.22..",
        ".333.#.2...",
        "...3...2...",
        ".G.........",
        "..........."
    ],
    "grid-006-n": [
        ".4444......",
        "......G333.",
        "00.....3...",
        "0....#.....",
        "0....#...22",
        "...#####22.",
        ".....#.....",
        ".....#.....",
        ".111....55.",
        "...1.....55",
        "..........S"
    ],
    "grid-007-n": [
        "..33..00...",
        ".33...00...",
        "S..........",
        ".....#..44.",
        ".5...#...4.",
        "555#####.4.",
        ".....#.....",
        "1....#.....",
        "1......222.",
        "1.G......2.",
        "1.........."
    ],
    "grid-008-n": [
        "..44.......",
        ".S4........",
        "..4........",
        ".....#.3333",
        "..0..#.....",
        "000#####55.",
        ".....#...5.",
        ".G...#...5.",
        "..1........",
        "111...222..",
        ".......2..."
    ],
    "grid-009-t": [
        "...........",
        ".44.....3..",
        ".S44...33..",
        ".....#.3...",
        "..0..#.....",
        "000#####...",
        ".....#.....",
        "..G..#55..2",
        "111...55..2",
        ".1.......22",
        "..........."
    ],
    "grid-010-n": [
	".......44..",
        ".00...44.S.",
        ".00........",
        ".....#.....",
        "55...#....1",
        "5..#####111",
        "5....#.....",
        ".....#.....",
        ".33.....222",
        "..33.....G2",
        "..........."
    ],
    "grid-011-n": [
	"........44.",
        ".00..S...44",
        "..00.......",
        ".....#.....",
        ".5...#....1",
        "555#####..1",
        ".....#...11",
        "..G..#.....",
        "..3....22..",
        ".333....22.",
        "..........."
    ]
}