{
    "grid-000-n": [
        "......0..44",
        ".55...0..4G",
        ".5....0..4.",
        ".5...#0....",
        ".....#.....",
        "111#####...",
        "..1..#.....",
        ".....#...3.",
        "...22...33.",
        "..22....3..",
        "S.........."
    ],
    "grid-001-n": [
	"........4G.",
        "....0...4..",
        "....0...44.",
        "....0#.....",
        "....0#....2",
        "555#####..2",
        "5....#....2",
        ".S...#....2",
        "..33.......",
        ".33......1.",
        "........111"
    ],
    "grid-002-n": [
        "G......3...",
        "4......3...",
        "444....33..",
        ".....#.....",
        "..0..#.....",
        "000#####...",
        ".....#.5..2",
        ".1...#.5..2",
        "111...55.22",
        "...........",
        "S.........."
    ],
    "grid-003-n": [
        "..33...4G..",
        "...3...444.",
        ".0.3.......",
        "000..#.....",
        ".....#.....",
        "...#####222",
        ".....#....2",
        ".S..1#55...",
        "...11..5...",
        "....1..5...",
        "..........."
    ],
    "grid-004-n": [
        "...3.......",
        "...3.....4.",
        "...33...44.",
        ".....#..G4.",
        "000..#....2",
        ".0.#####.22",
        ".....#....2",
        "..1..#.5...",
        "..1....5...",
        "S.1....5...",
        "..1....5..."
    ],
    "grid-005-n": [
	"..0...44...",
        ".00....4...",
        "..0....4..1",
        ".S...#...11",
        "5....#....1",
        "555#####...",
        ".....#.22..",
        ".333.#.2...",
        ".3.....2...",
        ".G.........",
        "..........."
    ],
    "grid-006-n": [
        ".4444......",
        "......G333.",
        ".000...3...",
        "...0.#.....",
        ".....#...22",
        "...#####22.",
        ".....#.....",
        ".....#.....",
        ".111....55.",
        "...1.....55",
        "..........S"
    ],
    "grid-007-n": [
        "..33..00...",
        ".33...00...",
        "S..........",
        ".....#..44.",
        ".5...#...4.",
        "555#####.4.",
        ".....#.....",
        ".....#.....",
        ".......222.",
        "1111.....2.",
        ".G........."
    ],
    "grid-008-n": [
        "..44.......",
        ".S44.......",
        "...........",
        ".....#.3333",
        "..0..#.....",
        "000#####55.",
        ".....#...5.",
        ".....#...5.",
        "...........",
        "1111..222..",
        ".G.....2..."
    ],
    "grid-009-n": [
        "...........",
        ".44.....3..",
        ".S44...33..",
        ".....#.3...",
        "..0..#.....",
        "000#####...",
        ".....#.....",
        ".....#55..2",
        "......55..2",
        "..G1.....22",
        ".111......."
    ],
    "grid-010-n": [
	".......44..",
        "..00..44.S.",
        ".00........",
        ".....#.....",
        "5....#....1",
        "5..#####111",
        "5....#.....",
        "5....#.....",
        "..3........",
        "..33...G222",
        "...3......2"
    ],
    "grid-011-n": [
	"..S0....44.",
        ".000....4..",
        "........4..",
        ".....#.....",
        ".5...#....1",
        "555#####..1",
        ".....#...11",
        "..G..#.....",
        "..3....22..",
        ".333....22.",
        "..........."
    ]
}