{
    "grid-000-l": [
        "..........G",
        "..33.......",
        "...3.......",
        "55.3.#.....",
        ".5...#...4.",
        ".5.#####444",
        ".....#2....",
        ".11..#2....",
        ".1....22...",
        ".1........0",
        "S.......000"
    ],
    "grid-001-l": [
        ".S....3333.",
        "...........",
        ".444...555.",
        ".4...#.5...",
        "0....#.....",
        "0..#####...",
        "00...#.....",
        ".....#.2222",
        ".11........",
        ".11..G.....",
        "..........."
    ],
    "grid-002-l": [
        "...........",
        ".000...G...",
        "...0.......",
        ".....#55...",
        ".....#55.33",
        "..4#####.3.",
        "..444#...3.",
        ".....#.....",
        "1.S........",
        "1.........2",
        "11......222"
    ],
    "grid-003-l": [
        "......5555.",
        "...G......2",
        ".........22",
        ".....#...2.",
        "33...#.....",
        "3.0#####...",
        "3.000#.....",
        ".....#.....",
        "..4.......1",
        ".444......1",
        "..S......11"
    ],
    "grid-004-l": [
        ".S.........",
        "...1...444.",
        ".111...4...",
        ".....#.....",
        ".....#....3",
        "...#####333",
        ".222.#0....",
        "...2.#00...",
        ".5....0....",
        ".55...G....",
        "..5........"
    ],
    "grid-005-l": [
        "....G..3333",
        ".444.......",
        ".4....22...",
        ".....#22...",
        "0....#.....",
        "00.#####...",
        "0....#.....",
        ".....#.....",
        ".111...555.",
        "...1....5..",
        "S.........."
    ],
    "grid-006-l": [
        "..G........",
        ".5.........",
        ".55........",
        "..5..#....0",
        ".....#..000",
        "..3#####...",
        "..33.#.4...",
        "..3..#.4...",
        "1......44..",
        "11...S.....",
        ".1....2222."
    ],
    "grid-007-l": [
        "..44..G....",
        "...4...33..",
        "...4...33..",
        ".....#.....",
        ".....#.....",
        ".00#####...",
        "..00.#..222",
        ".....#5...2",
        "1.....5....",
        "1S....55...",
        "11........."
    ],
    "grid-008-l": [
        "S..........",
        "..3......4.",
        ".33.....444",
        ".3...#.....",
        ".....#.....",
        "...#####.5.",
        "00...#..55.",
        ".00..#1.5..",
        "......1....",
        ".....G1....",
        ".2222.1...."
    ],
    "grid-009-l": [
	"....G.0000.",
        "44.........",
        "4.......555",
        "4....#...5.",
        ".222.#.....",
        ".2.#####...",
        ".....#....1",
        ".....#....1",
        "...33.....1",
        "..33......1",
        "..S........"
    ],
    "grid-010-l": [
        "....0......",
        "..G.0.55...",
        "4...0..55..",
        "4...0#.....",
        "44...#.....",
        "...#####33.",
        ".....#..33.",
        "...2.#.....",
        "..22....11.",
        "..2....11..",
        "......S...."
    ],
    "grid-011-l": [
        ".....G.....",
        "......333..",
        ".222....3.0",
        ".2...#....0",
        ".....#....0",
        "...#####..0",
        "..555#.1...",
        "....5#.1...",
        "44S....1...",
        "44.....1...",
        "..........."
    ]
}