{
    "grid-000-n": [
        "......0...4",
        ".55...0..G4",
        ".5....0..44",
        ".5...#0....",
        ".....#.....",
        "111#####...",
        "..1..#.....",
        ".....#...3.",
        "...22..333.",
        "..22.......",
        "..S........"
    ],
    "grid-001-n": [
	"........4..",
        "....0...4..",
        "....0...44.",
        "....0#.....",
        "....0#.....",
        "555#####...",
        "5....#222.G",
        ".....#2....",
        "..S33...11.",
        "..33....1..",
        "........1.."
    ],
    "grid-002-n": [
        ".......3...",
        "...4.G.3...",
        ".444...33..",
        ".....#....2",
        "..0..#....2",
        "000#####..2",
        ".....#.5..2",
        ".1...#.5...",
        "111...55...",
        "....S......",
        "..........."
    ],
    "grid-003-n": [
        "..33...4G..",
        "...3...444.",
        ".0.3.......",
        "000..#.....",
        ".....#.....",
        "...#####222",
        ".....#....2",
        ".S..1#55...",
        "...11..5...",
        "....1..5...",
        "..........."
    ],
    "grid-004-n": [
        "...3.......",
        "...3.....4.",
        "...33...44.",
        ".....#..G4.",
        "000..#....2",
        ".0.#####.22",
        ".....#....2",
        "..1..#.5...",
        "..1....5...",
        "S.1....5...",
        "..1....5..."
    ],
    "grid-005-n": [
	"..0...44...",
        ".00....4...",
        "..0....4..1",
        ".S...#...11",
        "5....#....1",
        "555#####...",
        ".....#.22..",
        ".333.#.2...",
        ".3.....2...",
        "........G..",
        "..........."
    ],
    "grid-006-n": [
        ".4444......",
        "......G33..",
        ".000...3...",
        "...0.#.3...",
        ".....#...22",
        "...#####22.",
        ".....#.....",
        ".....#.55..",
        ".111..S.55.",
        "...1.......",
        "..........."
    ],
    "grid-007-n": [
        "..33..00...",
        ".33...00...",
        "....S......",
        ".....#..44.",
        ".5...#...44",
        "555#####...",
        ".....#.....",
        "1....#.....",
        "1.....2222.",
        "11.........",
        "..G........"
    ],
    "grid-008-n": [
        "..44.......",
        "..44..S....",
        "........3..",
        ".....#..333",
        "..0..#.....",
        "000#####55.",
        ".....#...5.",
        ".....#...5.",
        "....G......",
        "1111..222..",
        "........2.."
    ],
    "grid-009-n": [
        "...........",
        ".444....3..",
        "..4.....3..",
        "....S#.33..",
        "..0..#.....",
        "000#####...",
        ".....#5....",
        ".....#55..2",
        "......5...2",
        ".1...G...22",
        ".111......."
    ],
    "grid-010-n": [
	".......44..",
        "..00..44...",
        ".00........",
        ".....#.S...",
        "5....#....1",
        "5..#####111",
        "5....#.....",
        "5.3..#.22..",
        "..3.....2..",
        ".33.....2..",
        ".G........."
    ],
    "grid-011-n": [
	"........44.",
        ".0000...4..",
        "..S.....4..",
        ".....#.....",
        ".5...#....1",
        "555#####..1",
        ".....#...11",
        ".....#.....",
        "..3....22..",
        ".333.G..22.",
        "..........."
    ]
}